,Position,Points SFL,Equipe,Match,Joueurs l'ayant choisi,total_choice,choix_autre,bet_safety
0,1,73,Hellas Vérone,Hellas Vérone 3 - 0 Milan,53,88,35,1.4722222222222223
1,2,70,Hertha Berlin,RB Leipzig 2 - 3 Hertha Berlin,25,115,90,0.27472527472527475
2,3,65,Yeni Malatyaspor,Yeni Malatyaspor 2 - 1 Galatasaray,3,28,25,0.11538461538461539
3,3,65,Lausanne-Sport,Lausanne-Sport 5 - 1 FC Zürich,24,27,3,6.0
4,5,49,Feyenoord,Sparta Rotterdam 0 - 7 Feyenoord,5,20,15,0.3125
5,6,48,Heracles,Utrecht 1 - 1 Heracles,5,9,4,1.0
6,6,48,Royal Antwerp,Zulte-Waregem 1 - 2 Royal Antwerp,61,74,13,4.357142857142857
7,8,45,FC Bruges,FC Bruges 5 - 0 Anderlecht,34,97,63,0.53125
8,9,43,US Sassuolo,Sampdoria 0 - 1 US Sassuolo,8,56,48,0.16326530612244897
9,10,42,Hanovre,Hanovre 4 - 4 Leverkusen,60,85,25,2.3076923076923075
10,11,39,Benfica,CD Tondela 1 - 5 Benfica,16,21,5,2.6666666666666665
11,12,37,Young Boys,Lucerne 2 - 4 Young Boys,7,24,17,0.3888888888888889
12,12,37,SPAL 2013,Benevento Calcio 1 - 2 SPAL 2013,39,96,57,0.6724137931034483
13,12,37,Excelsior,Excelsior 2 - 0 Groningue,5,8,3,1.25
14,12,37,Kayserispor,Akhisar Belediyespor 0 - 2 Kayserispor,26,34,8,2.888888888888889
15,12,37,Besiktas,Besiktas 5 - 1 Osmanlispor,39,45,6,5.571428571428571
16,17,36,Villarreal,Celta Vigo 0 - 1 Villarreal,84,125,41,2.0
17,18,35,Liverpool,Bournemouth 0 - 4 Liverpool,142,194,52,2.6792452830188678
18,19,34,İstanbul Basaksehir,İstanbul Basaksehir 4 - 1 Antalyaspor,15,29,14,1.0
19,20,32,Crotone FC,Crotone FC 1 - 0 Chievo,24,36,12,1.8461538461538463
20,21,31,Barcelone,Barcelone 4 - 0 La Corogne,328,378,50,6.431372549019608
21,21,31,Lyon,Lyon 2 - 0 Marseille,364,666,302,1.2013201320132014
22,23,30,Ajax,Alkmaar 1 - 2 Ajax,17,30,13,1.2142857142857142
23,23,30,Genoa,Fiorentina AC 0 - 0 Genoa,16,38,22,0.6956521739130435
24,23,30,Lazio,Atalanta Bergame 3 - 3 Lazio,171,212,41,4.071428571428571
25,26,29,Leverkusen,Hanovre 4 - 4 Leverkusen,25,85,60,0.4098360655737705
26,26,29,Juventus,Bologne 0 - 3 Juventus,111,115,4,22.2
27,28,28,Nice,Nice 1 - 0 Bordeaux,499,581,82,6.0120481927710845
28,28,28,FC Gérone,FC Gérone 1 - 0 Getafe,21,45,24,0.84
29,30,27,Atalanta Bergame,Atalanta Bergame 3 - 3 Lazio,41,212,171,0.23837209302325582
30,31,26,Manch. Utd,West Bromwich 1 - 2 Manch. Utd,180,209,29,6.0
31,31,26,Nantes,Nantes 1 - 0 Angers,219,302,83,2.607142857142857
32,33,25,Bâle,Grasshopper 0 - 2 Bâle,7,28,21,0.3181818181818182
33,33,25,Espanyol,Las Palmas 2 - 2 Espanyol,11,32,21,0.5
34,35,22,Sporting,Sporting 2 - 0 Portimonense,35,39,4,7.0
35,35,22,Las Palmas,Las Palmas 2 - 2 Espanyol,21,32,11,1.75
36,37,19,GD Chaves,GD Chaves 1 - 1 Rio Ave,7,15,8,0.7777777777777778
37,37,19,KRC Genk,Royal Charleroi 1 - 1 KRC Genk,5,72,67,0.07352941176470588
38,37,19,Rio Ave,GD Chaves 1 - 1 Rio Ave,8,15,7,1.0
39,40,17,Royal Charleroi,Royal Charleroi 1 - 1 KRC Genk,67,72,5,11.166666666666666
40,41,12,Utrecht,Utrecht 1 - 1 Heracles,4,9,5,0.6666666666666666
41,42,10,RB Leipzig,RB Leipzig 2 - 3 Hertha Berlin,90,115,25,3.4615384615384617
42,42,10,Lucerne,Lucerne 2 - 4 Young Boys,17,24,7,2.125
43,44,8,Fiorentina AC,Fiorentina AC 0 - 0 Genoa,22,38,16,1.2941176470588236
44,45,5,CD Tondela,CD Tondela 1 - 5 Benfica,5,21,16,0.29411764705882354
45,45,5,West Bromwich,West Bromwich 1 - 2 Manch. Utd,29,209,180,0.16022099447513813
46,45,5,Alkmaar,Alkmaar 1 - 2 Ajax,13,30,17,0.7222222222222222
47,45,5,Galatasaray,Yeni Malatyaspor 2 - 1 Galatasaray,25,28,3,6.25
48,45,5,Benevento Calcio,Benevento Calcio 1 - 2 SPAL 2013,57,96,39,1.425
49,45,5,FC Zürich,Lausanne-Sport 5 - 1 FC Zürich,3,27,24,0.12
50,45,5,Zulte-Waregem,Zulte-Waregem 1 - 2 Royal Antwerp,13,74,61,0.20967741935483872
51,45,5,Osmanlispor,Besiktas 5 - 1 Osmanlispor,6,45,39,0.15
52,45,5,Antalyaspor,İstanbul Basaksehir 4 - 1 Antalyaspor,14,29,15,0.875
53,54,0,Bologne,Bologne 0 - 3 Juventus,4,115,111,0.03571428571428571
54,54,0,Bournemouth,Bournemouth 0 - 4 Liverpool,52,194,142,0.36363636363636365
55,54,0,Bordeaux,Nice 1 - 0 Bordeaux,82,581,499,0.164
56,54,0,Angers,Nantes 1 - 0 Angers,83,302,219,0.37727272727272726
57,54,0,Sparta Rotterdam,Sparta Rotterdam 0 - 7 Feyenoord,15,20,5,2.5
58,54,0,Marseille,Lyon 2 - 0 Marseille,302,666,364,0.8273972602739726
59,54,0,Anderlecht,FC Bruges 5 - 0 Anderlecht,63,97,34,1.8
60,54,0,Milan,Hellas Vérone 3 - 0 Milan,35,88,53,0.6481481481481481
61,54,0,Grasshopper,Grasshopper 0 - 2 Bâle,21,28,7,2.625
62,54,0,Portimonense,Sporting 2 - 0 Portimonense,4,39,35,0.1111111111111111
63,54,0,Chievo,Crotone FC 1 - 0 Chievo,12,36,24,0.48
64,54,0,Sampdoria,Sampdoria 0 - 1 US Sassuolo,48,56,8,5.333333333333333
65,54,0,Groningue,Excelsior 2 - 0 Groningue,3,8,5,0.5
66,54,0,Getafe,FC Gérone 1 - 0 Getafe,24,45,21,1.0909090909090908
67,54,0,Celta Vigo,Celta Vigo 0 - 1 Villarreal,41,125,84,0.4823529411764706
68,54,0,Real Madrid,CD Leganes 0 - 0 Real Madrid,82,85,3,20.5
69,54,0,La Corogne,Barcelone 4 - 0 La Corogne,50,378,328,0.1519756838905775
70,54,0,Akhisar Belediyespor,Akhisar Belediyespor 0 - 2 Kayserispor,8,34,26,0.2962962962962963
71,54,0,CD Leganes,CD Leganes 0 - 0 Real Madrid,3,85,82,0.03614457831325301
